    __     _         _              
   / /    (_)_   __ (_)____   ____ _
  / /    / /| | / // // __ \ / __ `/
 / /___ / / | |/ // // / / // /_/ / 
/_____//_/  |___//_//_/ /_/ \__, /  
    ____                   /____/   
   / __ \ ____   ____   ____ ___    
  / /_/ // __ \ / __ \ / __ `__ \   
 / _, _// /_/ // /_/ // / / / / /   
/_/ |_| \____/ \____//_/ /_/ /_/    
                                    
